      NO textures/north.png
      WE textures/west.png
      SO    textures/south.png
      EA          textures/east.png

F			66, 110, 65
C			142,191,147


111111111
100000001
1000W0001
100000001
111111111
