NO textures/north.png
SO textures/south.png
WE textures/west.png
EA textures/east.png
F 66, 110, 65
C 0,0,0

111111111
100000001
1000N0001
100000001
111111111
110101010

