
NO ./assets/doom_1.png
SO ./assets/doom_13.png
WE ./assets/doom_2.png
EA ./assets/doom_14.png
F 133,98,69
C 161,89,38

11111111111  11111111111  11111111111  11111111111  11111111111  11111111111  11111111111
 100   001    100   001    100   001    100   001    100   001    100   001    100   001
  1000001      1000001      1000001     11S000011     1000001      1000001      1000001
   10001        10001        10001       1100011       10001        10001        10001
   10001        10001        10001        10001        10001        10001        10001
111111111111111111111111111111111111111111111111111111111111111111111111111111111111111111
