NO ./assets/tile_13.png
WE ./assets/tile_16.png
SO ./assets/tile_19.png
EA ./assets/tile_20.png
F 110,130,110
C 150,170,255

111111111111111111111111111
100000000000000000000000001
100000000000000000000000001
100000000000000000000000001
100000000000000000000000001
100000000000000000000000001
100000000000000000000000001
100000000000011000000000001
100000000000011000000000001
100000000000000000000000001
100000000000000000000000001
100000000000000000000000001
100000000000000000000110001
100011100000000000000000001
100000110000000000000000001
1                         1
100000000000000000000000001
100000000000000000000000001
100000000000000000000000001
100000000000001111100000001
100000000000000000000000001
100000000000000000000000001
10N00                 00001
111111111111111111111111111
