NO textures/north.png
WE textures/west.png
SO textures/south.png
EA textures/east.png
F 110,130,110
C 150,170,255

111111111111111111
100000000000000001
100000000000000001
10011011100000001
100000000000000001
100000000000000001
100000000000000001
100110111000000001
100000000000000001
10000000000000001
100000000000000001
100000000000S00001
100000000000000001
100011000000000001
100000110000000001
100000000000000001
100000000000000001
100000000000000001
100000000000000001
100000011111111111
10000001
10000001
10000001
11111111
