NO ./assets/no.png
WE ./assets/we.png
SO ./assets/so.png
EA ./assets/ea.png
F 66, 110, 65
C 142, 191, 187

   111111111111111
    1            1
    1    0000    1
    1    0N00    1
    1    0000    1
    1    0000    1
    1            1
    11111111111111
