NO ./assets/no.png
WE ./assets/we.png
SO ./assets/so.png
EA ./assets/ea.png
F 66, 110, 65
C 142, 191, 187

1111111111
1N00000001
1111111111
