NO ./assets/no.png
WE ./assets/we.png
SO ./assets/so.png
EA ./assets/ea.png
F 66, 110, 65
C 142, 191, 187



         1111111
11111111110000011111
11100000000001111111111111
  111111000000000000111
      11110000N0000011
      1111    0     1
      1111    0     11
      1111    0     111
      11111100000111111
      11111110001111111         11110
0           11011
00           101
000          101
0000         111
