NO textures/north.png
SO textures/south.png
WE textures/west.png
EA textures/east.png



F 128,128,128
C 0, 0, 0

111111
100001
10N001
111111