1111111111111111111111111
1000000000110001000000001
10110000011100N1010000001
1111110000000001000000011
    111110000000011100001
1111100000110000011101111
1111011111111101100000001
1111011111111101110101001
1100000011010101111111111
10000000000000001
1000000000000000111111111
1100000111010101111101111
1111111111111111111111111