NO textures/north.png
SO textures/south.png
WE textures/west.png
EA textures/east.png




F 220,100,0
C 225,30,0

1111111111111111111111111
1000000000110001000000001
10110000011100N1010000001
1111110000000001000000011
    111110000000011100001
11111000001100000111011111
111101111111110110000000001
11110111111111011101010011
1100000011010101111111111
10000000000000001
1000000000000000111111111
1100000111010101111101111
1111111111111111111111111