NO textures/north.png
SO textures/south.png
WE textures/west.png
EA textures/east.png
F 220,100,0
C 225,30,0

1111111111111
1000000000001
10N0011111101
100001    101
100001    101
100001    101
100001    101
100001    101
100001    101
1000011111101
1000000000001
1111111111111
