NO textures/north.png
SO textures/south.png
F 128,128,128
WE textures/west.png
C 0, 0, 0
EA textures/east.png
1111111111111
1000000000001
10N0011111101
100001    101
100001    101
100001    101
100001    101
100001    101
100001    101
1000011111101
1000000000001
1111111111111
