NO textures/north.png
SO textures/south.png
WE textures/west.png
EA textures/east.png

F 255,0,0
C 255,0,

111111111
1000N0001
111111111
