NO textures/north.png
SO textures/south.png
WE textures/west.png
EA textures/east.png
F 110,130,110
C 150,170,255

111111111111111111
100000000000000001
100000000000000001
100111 11111111111
100000E00000000001
100111 11111111001
100000000000001001
100000000000001001
111 11001111001001
100001001001001001
100001001001001001
10000 00100 001001
100001001001001001
100001001001001001
1000011110011 1001
100000000000000011
100111111111111111
100000000000000011
100000000000000001
100000000000000001
111 11111111111111
10000001
10000001
10000001
11111111
