NO textures/north.png
SO textures/south.png
WE textures/west.png
EA textures/east.png
F 66, 110, 65
C 142, 191, 187

1111111111
1100001001
1010100110
1001000001 
1N00000001
 11111111 
