NO textures/north.png
SO textures/south.png
WE textures/west.png
EA textures/east.png
F 255,0,0
C 200,8,8

111111111
111111111
111111111
