NO textures/north.png
SO textures/south.png
WE textures/west.png
EA textures/east.png
F 255,0,0
C 200,8,8

1111111111
1N00000001
11111111 1
